##########
#@       #
#        #
#$   $  X#
#X       #
##########
